0 9 5 0 7 0 0 0 0
0 7 0 0 0 6 0 9 8
0 0 0 3 0 0 6 0 0
0 0 7 0 0 5 0 0 6
4 0 3 0 0 2 0 1 0
0 0 0 7 0 0 0 0 0
5 3 0 0 2 0 0 0 4
0 8 6 0 0 0 0 0 3
7 0 2 0 9 3 0 0 0