0 1 0 6 0 0 0 5 0
0 0 0 5 4 0 0 0 2
0 0 0 0 9 8 4 0 0
9 0 0 0 0 0 6 0 5
2 0 0 0 0 0 0 0 8
3 0 8 0 0 0 0 0 1
0 0 2 8 5 0 0 0 0
6 0 0 0 7 3 0 0 0
0 7 0 0 0 9 0 6 0