0 0 0 0 0 3 8 0 0
0 0 0 0 0 0 9 5 0
0 9 0 0 0 0 0 2 0
0 0 7 0 0 0 2 4 0
1 6 0 2 4 0 0 9 0
9 0 0 0 0 0 0 0 6
4 0 6 0 1 0 0 0 0
5 8 0 0 0 0 0 0 0
0 1 9 4 8 0 0 6 0