0 0 0 8 0 0 0 0 0
0 0 0 0 0 3 5 0 0
0 7 6 0 0 1 0 8 0
7 0 0 3 0 8 9 2 0
3 0 9 0 4 0 0 0 0
0 0 0 7 0 0 0 0 4
9 8 0 0 2 0 7 4 0
4 0 2 0 8 7 6 0 0
6 1 7 0 3 4 0 0 0