0 0 9 0 5 0 8 2 0
3 0 0 0 0 0 0 0 0
0 0 2 0 0 0 1 0 9
9 0 8 5 0 6 2 3 0
0 0 0 0 0 0 0 0 0
0 2 5 8 0 4 9 0 1
6 0 3 0 0 0 7 0 0
0 0 0 0 0 0 0 0 8
0 8 1 0 9 0 3 0 0