1 2 0 0 0 7 0 0 0
3 4 9 8 5 1 0 0 7
5 0 0 2 0 3 9 0 0
0 3 2 1 0 0 0 0 0
0 0 0 0 0 0 0 0 0
0 0 0 0 0 2 7 3 0
0 0 3 6 0 9 0 0 8
9 0 0 0 1 8 0 7 0
0 0 0 7 0 5 0 9 4