0 0 0 0 0 0 4 0 8
0 0 1 0 8 0 0 0 0
0 0 0 6 0 0 9 7 0
5 0 8 9 0 1 0 0 0
3 0 0 0 0 0 0 0 0
0 0 0 5 2 8 0 3 0
8 0 7 0 0 0 0 0 0
0 0 0 0 0 4 5 0 0
0 6 2 8 9 0 0 0 0